-----------------------------------dar     ,  möbel  = meuble


wand  = wall         ;   
















------------------------------------- vocab

anzeige  = publicité



an der strand  = on the beach




saft  = juice







---------------------------------------adjective


langsam (adj) - er =  slow   -er 




lustig (adj ) -er  =    funny               , am lugtisten




 
wunderbar (adj)   =  wonderful


die Hose ist zu klein = pantalon dhaya9


suS  =  cute  / sweet



ich bin ledig  = single        !=  ich bin verheiratet



allein  = alone    ;   Heute sind viel leute allein (alone)




- du musst dich nicht schamen ( shame )         = you must not be ashamed 


- weit (adj) = loin     ;   die backerie ist nicht weit 	( not far ) 






---------------------------------------dbach


colors    :    gelbe =yellow



es passt mir / dir ..    =    it suits me ( fits me    / tla3 3laya ) 



es sieht toll aus =  looks great



jede farb   =   every color                 ;          jede farbe passt ihm     ( every col suits him )



die Schuhe  =  shoes



- an ziehen ( s habiller )          ;      ich ziehe die schuhe an 




- sie ziehen ihre kinder an        ( they dress their children )       



- aufraumen (v)  = to clean up



------------------------------------- mekla






















-------------------------------------transport



ich bin unterwegs zu dir    ( i am on my way to you )         ;     unterwegs  =  on my way





flugzeug  =  airplane














----------------------------------------- sante



kindheit    = enfance


die haare   = hair
















----------------------------------------------family

enkelin , enkel    =  grand daughter    , grand son



















-----------------------------------------------haus


 Schuhe  =  chaise