erzahlen   =  to  tell              ,     er immer witzer erzahlen       ( witzer =  jokes  ) 



laden  =  load     , einladen (v) = invite


aufstehe  =  get up     ;   stehe = stand



abfahren (v) = depart





aussteigen (v) =  to quit        ;       aussteigen bitte




pünktlich ich komme im büro an    ;      punklich  =  on time (adj)



anfange   =  to start



umsteigen (v) =  to transfer






anmachen  (allumer )  ,    zumachen  ( fermer )      ;    anmach  licht  bitte



aufschalten    (allumer)   !=  ausschalten (eteindre)           	  ;    um 17 Uhr schalte ich der computer aus 




aufraumen   =   nettoyer





anfangen   =  commencer      ,  das meeting  um   11 Uhr anfangt (start)






- Ich gehe allein ins Kino                ;      allein(e)    =   alone





zuruck kommen    =  revenir                    ;    zuruck (Noun)  =  retour






buchen (v)  hotels    =  to book





Schenken (v)  = give a gitft       ;   der mann schenkt der frau (dativ)   blume (akkus) ,






 gratulieren (v)   = feliciter ( grauliere , rst , rt , ren , rt , ren )      ;    der mann gratuliert der Frau




- gefallen (v) = to please                 ;    der Mann gefallt die Frau




- kennenlernen (v)   =   get to know         ;    kennenlernen phase  = period of knowing each other




- verwenden (v)   =   to use    ;   



- ich bin pünktlich da gewesen       (  i was there in time )




- treffen (v)    -   treffe (Noun)  = meeting   	;      aud der treffe  =  at the meeting
   




- aufstanden (v)    =  get up        ,    ( used after 



- anfangen (v)   =   to begin      ;     ich habe mit der arbeit angefangen                ;    anfangen  -  habe angefangen (perfekt)




- einladen (v)  = charger    !=  aufladen (v) = decharger




- warten  = wait      -  warte , est , tet , ten , tet , ten             - habe gewartet




-  rauchen (v)  = to smoke 





- vorstellen (v)  =  to introduce         ;    wir mochten uns vorstellen 




- anzieht (v)  - habe angezogen



- verpasse (v)   = to miss  - habe verpasst     ;  ich verpasse den zug      ;  