hilfst ?

haben .. zeit ?

haben = avoir


zeit - temps


erganzen  - ajouter a




kaufen - acheter


heute - today


nicht - pas(non , ba3d verbe )


schule  /chool/ - school


ferien  /feriin/ - vacance     , sie haben ferien ( they have holiday ) 


arbeiten  - travailler (v)



helfen - help (v)


geben - give (v)


zeigen - show(v)  -  sie seigt uns ihr haus     / she shows us her house


erklaren - explain(v)




helfen - help (v)


Ich habe ihr geholfen. -  I helped her.




lehrer (v) - etudier         *   lehrer (n) - professeur


erklären (v) - expliquer


Aufgabe (n) - task      *     Der Lehrer erklärt uns die Aufgabe




schicke (v) - envoyer     *   Ich schicke euch( dative of ihr ) eine E-Mail.



teuer (adj) - cher


nur (adj) - near   *  das kotet nur 3 euro


Futter (n) - food


klein (adj)  -  small   =! gross



wohnung (n) - appartement


chang (v) - changer





stuhle (n) - chaise



stadt (n) - ville




lust (n) - desir


keine - aucun





dann - donc




freundlich (adj)  -  friendly



Guten Tag, meine Herren     /    herren : plur of herr ( Mr )   gentelmen


Der Herr ist freundlich.




- er ist drei monate alt   ( he is 3 months old )



- sie sind su(ss)      - sweet


- mochen sie etwas trinken ?    ( want something to drink )        /       mochen : want







aus  VS   vom ?

->  aus + country  , exp : i kommen aus tunisia

-> vom + point /direction.. ,   exp :  ich habe das buch von meinem bruder

                                    "of" :    das auto von meinem vater              ( meinem NOT mein , cause von + dative )





besuch = visit

doch = but



kennen (v) = know



Mögen =  aimer







wir leben seit zehn jahren zusammen bei  unseren  elter



treffe = rencontrer      /   ich treffe meine mutter



ich helfe meinem kinder beim anziehen      ( beim anziehen = s habiller ) , beim = a




unter = under   /   das kind ist unter den tisch




stehen = stand    /   



anbieten  = offre   /  kann ich ihnen einen kaffe anbieten   ( can i offer you (formel) a coffee )



schlafen = sleep




treffen  = meet    /   Sie trifft ihre Schwester. 





spaziere (v) = walk



kaput (adj)   = broken     /     der bus ist kaput 


kalt(adj) = cold



teuer (adj)  =  expensive     /   das haus ist teuer




alt (lod) !=  neu   (new)




das ist moglich != unmoglich  		/   believable , unbelievable



leuten (n) = poeple      /     sprechen mit leuten